11111111111111111111111111111111111111
1V000000000000000011111111111111111111
11111111111111111011111111111111111111
11111111111111111011111111111111111111
11111111111111111011111111111111111111
1V000000000011111011111111111111111111
11111111111011111011111111111111111111
11111111111011111011111111111111111111
11111111111011111011111111111111111111
1V000011111011111011111111111111111111
11111011111011111011111111111111111111
11111011111011111011111111111111111111
11111011111011111011111111111111111111
1V0V0PCCCCCCCCCCCCCCCCCCCCCCCCCCCCCE11
11011111011111011111111111111111111111
1V011111011111011111111111111111111111
11111111V11111V11111111111111111111111
11111111111111111111111111111111111111


