11111111111
1E00000P111
1C00000V111
11111111111
10101010101
11111111111